11111111111111
1P000100000001
1000C1000C0001
11100000000001
10000000011111
100C0100000001
100001000CE001
11111111111111