111111111111111111
1P000C1C00010000C1
100000111101011111
100000100001000001
111110100001000001
1000001011C10000C1
100000000000000111
1011110011111111E1
1000C1000000000001
111111111111111111