111111111111111111
10C01Z1111111100E1
1Z0011111111110111
100000000000000111
101111111111011111
1000000000C1011111
111111111111011111
100000000000011111
10CC011111110000C1
1000z1111111111111
110111111110000C11
110111000000000011
110111011110000z11
1Z0000001111101111
100000001111100011
1C00C00C1111111011
111111111110000001
1P0000000000000001
1111111111100000C1
111111111111111111