1111111111111
1Z10000000001
1Z10000000001
1Z10000000001
1Z10000E00001
1Z10000000001
1Z10000000001
1Z10000000001
1Z10000000001
1Z10000000001
1Z10000000001
1Z10000P00001
1Z10000000001
1Z10000000001
1Z10000000001
1Z10000000001
1Z10000000001
1Z10000000001
1Z10000000001
1Z10000000001
1Z10000000001
1Z10000000001
1Z10000000001
1111111111111