1111111111111111111111111111111111111111111111
10000000000000000000000000000000000001000Z0001
10000000000000000000000000000000000001000Z0001
10000000000000000000000000000000000001000Z0001
10000000000000000000000000000000000001000Z0001
10000000000000000000000000000000000001000Z0001
10000000000000000000000000000000000001000Z0001
1111111111111111111111111111111111111111111111
10000000000000000000000000000000000001000Z0001
10000000000000000000000000000000000001000Z0001
10000000000000000000000000000000000001000Z0001
10000000000000000000000000000000000001000Z0001
10000000000000000000000000000000000001000Z0001
1PC0000000000000000000000000000000E001000Z0001
10111111111111111111111111111111111101000Z0001
10000000000000000000000000000000000001000Z0001
10000000000000000000000000000000000001000Z0001
10000000000000000000000000000000000001000Z0001
10000000000000000000000000000000000001000Z0001
10000000000000000000000000000000000001000Z0001
10000000000000000000000000000000000001000Z0001
10000000000000000000000000000000000001000Z0001
1111111111111111111111111111111111111111111111